5 5
11111
10001
10@01
10001
11111
