10 10
1111111111
1001001101
1011000101
1001010101
1000001101
1111000001
1011000111
1010101111
1000000001
1111111111
